,machine,reward,num_actions,max_RUL,slack,reward_estimate
0,1,-456,30,30,0,-15.2
1,2,-196,5,48,43,-4.08
2,3,45,45,125,80,0.36
3,4,-186,15,105,90,-1.77
4,5,-181,20,97,77,-1.87
5,6,-193,8,104,96,-1.86
6,7,-200,1,159,158,-1.26
7,8,-191,10,165,155,-1.16
8,9,-200,1,54,53,-3.7
9,10,-196,5,191,186,-1.03
10,11,-190,11,82,71,-2.32
11,12,-147,54,216,162,-0.68
12,13,-194,7,194,187,-1.0
13,14,233,34,45,11,5.18
14,15,-195,6,75,69,-2.6
15,16,66,66,112,46,0.59
16,17,-173,28,164,136,-1.05
17,18,-194,7,132,125,-1.47
18,19,49,49,134,85,0.37
19,20,63,63,183,120,0.34
20,21,-195,6,147,141,-1.33
21,22,-192,9,38,29,-5.05
22,23,-188,13,129,116,-1.46
23,24,-154,47,185,138,-0.83
24,25,32,32,47,15,0.68
25,26,-188,13,75,62,-2.51
26,27,-174,27,139,112,-1.25
27,28,61,61,157,96,0.39
28,29,-179,22,170,148,-1.05
29,30,-190,11,142,131,-1.34
30,31,-154,47,195,148,-0.79
31,32,-194,7,144,137,-1.35
32,33,-198,3,49,46,-4.04
33,34,-187,14,202,188,-0.93
34,35,-173,28,197,169,-0.88
35,36,-183,18,125,107,-1.46
36,37,-190,11,120,109,-1.58
37,38,46,46,124,78,0.37
38,39,19,19,36,17,0.53
39,40,-200,1,132,131,-1.52
40,41,-188,13,122,109,-1.54
41,42,-192,9,155,146,-1.24
42,43,-192,9,171,162,-1.12
43,44,-433,53,53,0,-8.17
44,45,-184,17,151,134,-1.22
45,46,-189,12,145,133,-1.3
46,47,48,48,72,24,0.67
47,48,-196,5,77,72,-2.55
48,49,-157,44,302,258,-0.52
49,50,-197,4,73,69,-2.7
50,51,63,63,143,80,0.44
51,52,-192,9,188,179,-1.02
52,53,-180,21,163,142,-1.1
53,54,-169,32,120,88,-1.41
54,55,-171,30,112,82,-1.53
55,56,-194,7,135,128,-1.44
56,57,59,59,159,100,0.37
57,58,58,58,175,117,0.33
58,59,-187,14,93,79,-2.01
59,60,-160,41,146,105,-1.1
60,61,-174,27,158,131,-1.1
61,62,-177,24,231,207,-0.77
62,63,94,94,154,60,0.61
63,64,59,59,167,108,0.35
64,65,-184,17,70,53,-2.63
65,66,-159,42,146,104,-1.09
66,67,-190,11,70,59,-2.71
67,68,-174,27,186,159,-0.94
68,69,-199,2,53,51,-3.75
69,70,-182,19,151,132,-1.21
70,71,-189,12,67,55,-2.82
71,72,-191,10,130,120,-1.47
72,73,-375,111,111,0,-3.38
73,74,-176,25,136,111,-1.29
74,75,-197,4,87,83,-2.26
75,76,-196,5,204,199,-0.96
76,77,-198,3,161,158,-1.23
77,78,-193,8,71,63,-2.72
78,79,-173,28,100,72,-1.73
79,80,-199,2,132,130,-1.51
80,81,-195,6,212,206,-0.92
81,82,53,53,161,108,0.33
82,83,-195,6,72,66,-2.71
83,84,64,64,171,107,0.37
84,85,232,33,33,0,7.03
85,86,60,60,109,49,0.55
86,87,-431,55,55,0,-7.84
87,88,40,40,67,27,0.6
88,89,-197,4,176,172,-1.12
89,90,-186,15,145,130,-1.28
90,91,-190,11,233,222,-0.82
91,92,-187,14,149,135,-1.26
92,93,-156,45,243,198,-0.64
93,94,-194,7,132,125,-1.47
94,95,61,61,88,27,0.69
95,96,292,93,96,3,3.04
96,97,-199,2,133,131,-1.5
97,98,-190,11,120,109,-1.58
98,99,-191,10,96,86,-1.99
99,100,-197,4,197,193,-1.0
100,101,180,180,257,77,0.7
101,102,-432,54,54,0,-8.0
102,103,54,54,164,110,0.33
103,104,-401,85,85,0,-4.72
104,105,89,89,147,58,0.61
105,106,-424,62,62,0,-6.84
106,107,-303,183,183,0,-1.66
107,108,75,75,172,97,0.44
108,109,70,70,160,90,0.44
109,110,-403,83,83,0,-4.86
110,111,61,61,161,100,0.38
111,112,-413,73,73,0,-5.66
112,113,362,163,163,0,2.22
113,114,-327,159,159,0,-2.06
114,115,-322,164,164,0,-1.96
115,116,-183,18,87,69,-2.1
116,117,450,251,263,12,1.71
117,118,-447,39,39,0,-11.46
118,119,-172,29,171,142,-1.01
119,120,-386,100,100,0,-3.86
120,121,-359,127,127,0,-2.83
121,122,-185,16,158,142,-1.17
122,123,-438,48,48,0,-9.12
123,124,-277,209,209,0,-1.33
124,125,93,93,146,53,0.64
125,126,272,73,75,2,3.63
126,127,-419,67,67,0,-6.25
127,128,-464,22,22,0,-21.09
128,129,292,93,100,7,2.92
129,130,353,154,183,29,1.93
130,131,-180,21,122,101,-1.48
131,132,-152,49,169,120,-0.9
132,133,-186,15,134,119,-1.39
133,134,16,16,51,35,0.31
134,135,-186,15,76,61,-2.45
135,136,91,91,162,71,0.56
136,137,-438,48,48,0,-9.12
137,138,-360,126,126,0,-2.86
138,139,-182,19,148,129,-1.23
139,140,-177,24,182,158,-0.97
140,141,-277,209,209,0,-1.33
141,142,-350,136,136,0,-2.57
142,143,-149,52,183,131,-0.81
143,144,348,149,163,14,2.13
144,145,121,121,194,73,0.62
145,146,-178,23,131,108,-1.36
146,147,-406,80,80,0,-5.08
147,148,-183,18,131,113,-1.4
148,149,31,31,64,33,0.48
149,150,101,101,163,62,0.62
150,151,-450,36,36,0,-12.5
151,152,337,138,164,26,2.05
152,153,-338,148,148,0,-2.28
153,154,-413,73,73,0,-5.66
154,155,77,77,122,45,0.63
155,156,-414,72,72,0,-5.75
156,157,-411,75,75,0,-5.48
157,158,-146,55,246,191,-0.59
158,159,-465,21,21,0,-22.14
159,160,-170,31,143,112,-1.19
160,161,258,59,69,10,3.74
161,162,-154,47,204,157,-0.75
162,163,-197,4,173,169,-1.14
163,164,-166,35,232,197,-0.72
164,165,166,166,366,200,0.45
165,166,-197,4,62,58,-3.18
166,167,-163,38,145,107,-1.12
167,168,90,90,217,127,0.41
168,169,347,148,157,9,2.21
169,170,-197,4,263,259,-0.75
170,171,-422,64,64,0,-6.59
171,172,49,49,142,93,0.35
172,173,-336,150,150,0,-2.24
173,174,-194,7,102,95,-1.9
174,175,122,122,191,69,0.64
175,176,99,99,221,122,0.45
176,177,-200,1,66,65,-3.03
177,178,64,64,127,63,0.5
178,179,-374,112,112,0,-3.34
179,180,-168,33,277,244,-0.61
180,181,258,59,75,16,3.44
181,182,-391,95,95,0,-4.12
182,183,-466,20,20,0,-23.3
183,184,-283,203,203,0,-1.39
184,185,-146,55,182,127,-0.8
185,186,-404,82,82,0,-4.93
186,187,-356,130,130,0,-2.74
187,188,59,59,165,106,0.36
188,189,35,35,58,23,0.6
189,190,105,105,162,57,0.65
190,191,-176,25,277,252,-0.64
191,192,-364,122,122,0,-2.98
192,193,-411,75,75,0,-5.48
193,194,296,97,116,19,2.55
194,195,44,44,77,33,0.57
195,196,304,105,139,34,2.19
196,197,395,196,212,16,1.86
197,198,-374,112,112,0,-3.34
198,199,334,135,162,27,2.06
199,200,-338,148,148,0,-2.28
200,201,228,29,37,8,6.16
201,202,-365,121,121,0,-3.02
202,203,-156,45,185,140,-0.84
203,204,95,95,140,45,0.68
204,205,-426,60,60,0,-7.1
205,206,-182,19,71,52,-2.56
206,207,-355,131,131,0,-2.71
207,208,-187,14,173,159,-1.08
208,209,-171,30,143,113,-1.2
209,210,-180,21,218,197,-0.83
210,211,313,114,130,16,2.41
211,212,-196,5,108,103,-1.81
212,213,-442,44,44,0,-10.05
213,214,325,126,152,26,2.14
214,215,108,108,209,101,0.52
215,216,-316,170,170,0,-1.86
216,217,-432,54,54,0,-8.0
217,218,-390,96,96,0,-4.06
218,219,398,199,201,2,1.98
219,220,92,92,159,67,0.58
220,221,-428,58,58,0,-7.38
221,222,-458,28,28,0,-16.36
222,223,-426,60,60,0,-7.1
223,224,-195,6,148,142,-1.32
224,225,-408,78,78,0,-5.23
225,226,278,79,98,19,2.84
226,227,299,100,125,25,2.39
227,228,-200,1,109,108,-1.83
228,229,-269,217,217,0,-1.24
229,230,-346,140,140,0,-2.47
230,231,-414,72,72,0,-5.75
231,232,50,50,121,71,0.41
232,233,379,180,185,5,2.05
233,234,378,179,185,6,2.04
234,235,46,46,119,73,0.39
235,236,-410,76,76,0,-5.39
236,237,-154,47,225,178,-0.68
237,238,-149,52,199,147,-0.75
238,239,-371,115,115,0,-3.23
239,240,-111,90,305,215,-0.36
240,241,43,43,68,25,0.63
241,242,108,108,162,54,0.67
242,243,107,107,225,118,0.48
243,244,-195,6,142,136,-1.37
244,245,-345,141,141,0,-2.45
245,246,-343,143,143,0,-2.4
246,247,-409,77,77,0,-5.31
247,248,-162,39,156,117,-1.04
248,249,-184,17,69,52,-2.67
249,250,380,181,195,14,1.95
250,251,-161,40,140,100,-1.15
251,252,48,48,89,41,0.54
252,253,-341,145,145,0,-2.35
253,254,-429,57,57,0,-7.53
254,255,-415,71,71,0,-5.85
255,256,273,74,74,0,3.69
256,257,60,60,160,100,0.38
257,258,-316,170,170,0,-1.86
258,259,363,164,186,22,1.95
259,260,-363,123,123,0,-2.95
260,261,322,123,173,50,1.86
261,262,355,156,184,28,1.93
262,263,-182,19,143,124,-1.27
263,264,-186,15,198,183,-0.94
264,265,-452,34,34,0,-13.29
265,266,-390,96,96,0,-4.06
266,267,-199,2,77,75,-2.58
267,268,38,38,106,68,0.36
268,269,-407,79,79,0,-5.15
269,270,-402,84,84,0,-4.79
270,271,-183,18,242,224,-0.76
271,272,-359,127,127,0,-2.83
272,273,-370,116,116,0,-3.19
273,274,-436,50,50,0,-8.72
274,275,48,48,82,34,0.59
275,276,125,125,199,74,0.63
276,277,71,71,190,119,0.37
277,278,-433,53,53,0,-8.17
278,279,-173,28,155,127,-1.12
279,280,-185,16,153,137,-1.21
280,281,122,122,198,76,0.62
281,282,78,78,133,55,0.59
282,283,-337,149,149,0,-2.26
283,284,-423,63,63,0,-6.71
284,285,424,225,253,28,1.68
285,286,61,61,165,104,0.37
286,287,277,78,83,5,3.34
287,288,-401,85,85,0,-4.72
288,289,-178,23,177,154,-1.01
289,290,94,94,157,63,0.6
290,291,42,42,94,52,0.45
291,292,-326,160,160,0,-2.04
292,293,162,162,244,82,0.66
293,294,-198,3,49,46,-4.04
294,295,399,200,261,61,1.53
295,296,-378,108,108,0,-3.5
296,297,-428,58,58,0,-7.38
297,298,-367,119,119,0,-3.08
298,299,-171,30,116,86,-1.47
299,300,-427,59,59,0,-7.24
300,301,-462,24,24,0,-19.25
301,302,69,69,123,54,0.56
302,303,-372,114,114,0,-3.26
303,304,-446,40,40,0,-11.15
304,305,-456,30,30,0,-15.2
305,306,-325,161,161,0,-2.02
306,307,50,50,140,90,0.36
307,308,-175,26,165,139,-1.06
308,309,-356,130,130,0,-2.74
309,310,379,180,181,1,2.09
310,311,-177,24,154,130,-1.15
311,312,-181,20,186,166,-0.97
312,313,-328,158,158,0,-2.08
313,314,-412,74,74,0,-5.57
314,315,255,56,70,14,3.64
315,316,63,63,99,36,0.64
316,317,-187,14,48,34,-3.9
317,318,-454,32,32,0,-14.19
318,319,331,132,160,28,2.07
319,320,-196,5,53,48,-3.7
320,321,-432,54,54,0,-8.0
321,322,-149,52,179,127,-0.83
322,323,-458,28,28,0,-16.36
323,324,-444,42,42,0,-10.57
324,325,-151,50,165,115,-0.92
325,326,320,121,164,43,1.95
326,327,110,110,179,69,0.61
327,328,27,27,43,16,0.63
328,329,-378,108,108,0,-3.5
329,330,-362,124,124,0,-2.92
330,331,119,119,186,67,0.64
331,332,-199,2,158,156,-1.26
332,333,229,30,39,9,5.87
333,334,-165,36,146,110,-1.13
334,335,-178,23,101,78,-1.76
335,336,-174,27,273,246,-0.64
336,337,-161,40,234,194,-0.69
337,338,53,53,93,40,0.57
338,339,-182,19,105,86,-1.73
339,340,241,42,49,7,4.92
340,341,-443,43,43,0,-10.3
341,342,-293,193,193,0,-1.52
342,343,-447,39,39,0,-11.46
343,344,-195,6,48,42,-4.06
344,345,-162,39,264,225,-0.61
345,346,-407,79,79,0,-5.15
346,347,-400,86,86,0,-4.65
347,348,-189,12,161,149,-1.17
348,349,-191,10,35,25,-5.46
349,350,-149,52,233,181,-0.64
350,351,-423,63,63,0,-6.71
351,352,151,151,248,97,0.61
352,353,-175,26,138,112,-1.27
353,354,71,71,130,59,0.55
354,355,-187,14,149,135,-1.26
355,356,-428,58,58,0,-7.38
356,357,-169,32,198,166,-0.85
357,358,-389,97,97,0,-4.01
358,359,-364,122,122,0,-2.98
359,360,-152,49,232,183,-0.66
360,361,-166,35,123,88,-1.35
361,362,-155,46,233,187,-0.67
362,363,-419,67,67,0,-6.25
363,364,-197,4,137,133,-1.44
364,365,-194,7,63,56,-3.08
365,366,-198,3,157,154,-1.26
366,367,-198,3,191,188,-1.04
367,368,-176,25,237,212,-0.74
368,369,44,44,130,86,0.34
369,370,70,70,102,32,0.69
370,371,59,59,145,86,0.41
371,372,-200,1,64,63,-3.12
372,373,-184,17,168,151,-1.1
373,374,36,36,111,75,0.32
374,375,-178,23,125,102,-1.42
375,376,122,122,229,107,0.53
376,377,80,80,243,163,0.33
377,378,54,54,114,60,0.47
378,379,-170,31,206,175,-0.83
379,380,172,172,262,90,0.66
380,381,-169,32,118,86,-1.43
381,382,-194,7,404,397,-0.48
382,383,-199,2,474,472,-0.42
383,384,-186,15,168,153,-1.11
384,385,-174,27,129,102,-1.35
385,386,-188,13,103,90,-1.83
386,387,-417,69,69,0,-6.04
387,388,273,74,88,14,3.1
388,389,-190,11,332,321,-0.57
389,390,327,128,151,23,2.17
390,391,-171,30,119,89,-1.44
391,392,94,94,179,85,0.53
392,393,49,49,104,55,0.47
393,394,94,94,143,49,0.66
394,395,-186,15,89,74,-2.09
395,396,-197,4,46,42,-4.28
396,397,-163,38,132,94,-1.23
397,398,209,209,309,100,0.68
398,399,-174,27,312,285,-0.56
399,400,51,51,100,49,0.51
400,401,31,31,86,55,0.36
401,402,-171,30,132,102,-1.3
402,403,-198,3,145,142,-1.37
403,404,-187,14,87,73,-2.15
404,405,-172,29,179,150,-0.96
405,406,-198,3,55,52,-3.6
406,407,-174,27,178,151,-0.98
407,408,-141,60,210,150,-0.67
408,409,67,67,146,79,0.46
409,410,-193,8,117,109,-1.65
410,411,-196,5,37,32,-5.3
411,412,-180,21,107,86,-1.68
412,413,34,34,49,15,0.69
413,414,64,64,202,138,0.32
414,415,-156,45,161,116,-0.97
415,416,-189,12,157,145,-1.2
416,417,-188,13,118,105,-1.59
417,418,70,70,148,78,0.47
418,419,282,83,111,28,2.54
419,420,-409,77,77,0,-5.31
420,421,-186,15,223,208,-0.83
421,422,-165,36,136,100,-1.21
422,423,-162,39,270,231,-0.6
423,424,-199,2,78,76,-2.55
424,425,-171,30,121,91,-1.41
425,426,-177,24,185,161,-0.96
426,427,-187,14,187,173,-1.0
427,428,60,60,104,44,0.58
428,429,-199,2,83,81,-2.4
429,430,-189,12,366,354,-0.52
430,431,-166,35,231,196,-0.72
431,432,-197,4,108,104,-1.82
432,433,-184,17,67,50,-2.75
433,434,89,89,190,101,0.47
434,435,-195,6,179,173,-1.09
435,436,-152,49,380,331,-0.4
436,437,-183,18,278,260,-0.66
437,438,-174,27,169,142,-1.03
438,439,273,74,84,10,3.25
439,440,-189,12,154,142,-1.23
440,441,-196,5,193,188,-1.02
441,442,-183,18,167,149,-1.1
442,443,26,26,75,49,0.35
443,444,56,56,117,61,0.48
444,445,95,95,173,78,0.55
445,446,-167,34,217,183,-0.77
446,447,232,33,40,7,5.8
447,448,44,44,119,75,0.37
448,449,-187,14,205,191,-0.91
449,450,-190,11,55,44,-3.45
450,451,-191,10,265,255,-0.72
451,452,-200,1,157,156,-1.27
452,453,-168,33,332,299,-0.51
453,454,67,67,212,145,0.32
454,455,-101,100,357,257,-0.28
455,456,39,39,94,55,0.41
456,457,93,93,181,88,0.51
457,458,-188,13,288,275,-0.65
458,459,94,94,246,152,0.38
459,460,-155,46,229,183,-0.68
460,461,51,51,152,101,0.34
461,462,73,73,140,67,0.52
462,463,-173,28,207,179,-0.84
463,464,-436,50,50,0,-8.72
464,465,-191,10,145,135,-1.32
465,466,-433,53,53,0,-8.17
466,467,75,75,247,172,0.3
467,468,105,105,283,178,0.37
468,469,-464,22,22,0,-21.09
469,470,28,28,81,53,0.35
470,471,-124,77,269,192,-0.46
471,472,-187,14,226,212,-0.83
472,473,288,89,101,12,2.85
473,474,-161,40,167,127,-0.96
474,475,412,213,239,26,1.72
475,476,-135,66,333,267,-0.41
476,477,440,241,246,5,1.79
477,478,-463,23,23,0,-20.13
478,479,-372,114,114,0,-3.26
479,480,-145,56,201,145,-0.72
480,481,338,139,157,18,2.15
481,482,-325,161,161,0,-2.02
482,483,-189,12,173,161,-1.09
483,484,-81,120,485,365,-0.17
484,485,40,40,89,49,0.45
485,486,-159,42,143,101,-1.11
486,487,-467,19,19,0,-24.58
487,488,381,182,215,33,1.77
488,489,-258,228,228,0,-1.13
489,490,57,57,133,76,0.43
490,491,-177,24,259,235,-0.68
491,492,-380,106,106,0,-3.58
492,493,-147,54,360,306,-0.41
493,494,127,127,277,150,0.46
494,495,75,75,158,83,0.47
495,496,153,153,344,191,0.44
496,497,64,64,124,60,0.52
497,498,107,107,213,106,0.5
498,499,-221,265,265,0,-0.83
499,500,257,257,413,156,0.62
500,501,342,143,199,56,1.72
501,502,310,111,119,8,2.61
502,503,-166,35,405,370,-0.41
503,504,-409,77,77,0,-5.31
504,505,234,35,36,1,6.5
505,506,400,201,223,22,1.79
506,507,-169,32,213,181,-0.79
507,508,-189,12,272,260,-0.69
508,509,86,86,205,119,0.42
509,510,-350,136,136,0,-2.57
510,511,-429,57,57,0,-7.53
511,512,-420,66,66,0,-6.36
512,513,-188,13,80,67,-2.35
513,514,-176,25,102,77,-1.73
514,515,-307,179,179,0,-1.72
515,516,-184,17,120,103,-1.53
516,517,348,149,184,35,1.89
517,518,-450,36,36,0,-12.5
518,519,-352,134,134,0,-2.63
519,520,524,325,395,70,1.33
520,521,-247,239,239,0,-1.03
521,522,102,102,157,55,0.65
522,523,427,228,250,22,1.71
523,524,-165,36,185,149,-0.89
524,525,287,88,96,8,2.99
525,526,80,80,149,69,0.54
526,527,-155,46,240,194,-0.65
527,528,83,83,161,78,0.52
528,529,-168,33,189,156,-0.89
529,530,-195,291,291,0,-0.67
530,531,-172,29,117,88,-1.47
531,532,-338,148,148,0,-2.28
532,533,417,218,222,4,1.88
533,534,74,74,202,128,0.37
534,535,-439,47,47,0,-9.34
535,536,-188,13,107,94,-1.76
536,537,-381,105,105,0,-3.63
537,538,-303,183,183,0,-1.66
538,539,47,47,111,64,0.42
539,540,257,58,59,1,4.36
540,541,-341,145,145,0,-2.35
541,542,185,185,273,88,0.68
542,543,273,74,87,13,3.14
543,544,54,54,173,119,0.31
544,545,-136,65,253,188,-0.54
545,546,-320,166,166,0,-1.93
546,547,65,65,139,74,0.47
547,548,188,188,284,96,0.66
548,549,312,113,117,4,2.67
549,550,95,95,143,48,0.66
550,551,-188,13,115,102,-1.63
551,552,349,150,199,49,1.75
552,553,34,34,104,70,0.33
553,554,56,56,109,53,0.51
554,555,300,101,122,21,2.46
555,556,-436,50,50,0,-8.72
556,557,-405,81,81,0,-5.0
557,558,-200,1,236,235,-0.85
558,559,-190,11,195,184,-0.97
559,560,-190,11,165,154,-1.15
560,561,268,268,442,174,0.61
561,562,75,75,144,69,0.52
562,563,-422,64,64,0,-6.59
563,564,137,137,350,213,0.39
564,565,-339,147,147,0,-2.31
565,566,-366,120,120,0,-3.05
566,567,62,62,144,82,0.43
567,568,-186,15,65,50,-2.86
568,569,461,262,347,85,1.33
569,570,-199,2,341,339,-0.58
570,571,-399,87,87,0,-4.59
571,572,82,82,131,49,0.63
572,573,-141,60,217,157,-0.65
573,574,-405,81,81,0,-5.0
574,575,-170,31,160,129,-1.06
575,576,-390,96,96,0,-4.06
576,577,76,76,177,101,0.43
577,578,81,81,227,146,0.36
578,579,-151,50,169,119,-0.89
579,580,-181,20,193,173,-0.94
580,581,-370,116,116,0,-3.19
581,582,-200,1,235,234,-0.85
582,583,-166,35,229,194,-0.72
583,584,-466,20,20,0,-23.3
584,585,-161,40,219,179,-0.74
585,586,31,31,97,66,0.32
586,587,-348,138,138,0,-2.52
587,588,-172,314,314,0,-0.55
588,589,284,85,106,21,2.68
589,590,83,83,192,109,0.43
590,591,288,89,114,25,2.53
591,592,-413,73,73,0,-5.66
592,593,120,120,265,145,0.45
593,594,156,156,434,278,0.36
594,595,-431,55,55,0,-7.84
595,596,150,150,290,140,0.52
596,597,138,138,238,100,0.58
597,598,263,64,87,23,3.02
598,599,99,99,159,60,0.62
599,600,-468,18,18,0,-26.0
600,601,-418,68,68,0,-6.15
601,602,-194,7,326,319,-0.6
602,603,12,12,33,21,0.36
603,604,-385,101,101,0,-3.81
604,605,-403,83,83,0,-4.86
605,606,-371,115,115,0,-3.23
606,607,81,81,125,44,0.65
607,608,-125,76,319,243,-0.39
608,609,383,184,201,17,1.91
609,610,190,190,284,94,0.67
610,611,366,167,194,27,1.89
611,612,307,108,129,21,2.38
612,613,-165,36,121,85,-1.36
613,614,-186,15,160,145,-1.16
614,615,-459,27,27,0,-17.0
615,616,-349,137,137,0,-2.55
616,617,-160,41,170,129,-0.94
617,618,-172,29,159,130,-1.08
618,619,-200,1,121,120,-1.65
619,620,140,140,256,116,0.55
620,621,274,75,98,23,2.8
621,622,-365,121,121,0,-3.02
622,623,15,15,28,13,0.54
623,624,-309,177,177,0,-1.75
624,625,34,34,62,28,0.55
625,626,-388,98,98,0,-3.96
626,627,-413,73,73,0,-5.66
627,628,-195,6,33,27,-5.91
628,629,-439,47,47,0,-9.34
629,630,-193,8,354,346,-0.55
630,631,-175,26,131,105,-1.34
631,632,-175,26,150,124,-1.17
632,633,-178,23,134,111,-1.33
633,634,-371,115,115,0,-3.23
634,635,-302,184,184,0,-1.64
635,636,54,54,145,91,0.37
636,637,-176,25,278,253,-0.63
637,638,121,121,261,140,0.46
638,639,125,125,366,241,0.34
639,640,-288,198,198,0,-1.45
640,641,272,73,97,24,2.8
641,642,-362,124,124,0,-2.92
642,643,55,55,153,98,0.36
643,644,63,63,202,139,0.31
644,645,-440,46,46,0,-9.57
645,646,-173,28,120,92,-1.44
646,647,105,105,156,51,0.67
647,648,52,52,106,54,0.49
648,649,74,74,199,125,0.37
649,650,-416,70,70,0,-5.94
650,651,-284,202,202,0,-1.41
651,652,-134,67,262,195,-0.51
652,653,103,103,213,110,0.48
653,654,-173,28,185,157,-0.94
654,655,-417,69,69,0,-6.04
655,656,-172,29,195,166,-0.88
656,657,70,70,114,44,0.61
657,658,-170,31,176,145,-0.97
658,659,-372,114,114,0,-3.26
659,660,-348,138,138,0,-2.52
660,661,-192,9,221,212,-0.87
661,662,49,49,86,37,0.57
662,663,-468,18,18,0,-26.0
663,664,-181,20,94,74,-1.93
664,665,171,171,290,119,0.59
665,666,367,168,178,10,2.06
666,667,-307,179,179,0,-1.72
667,668,-192,9,170,161,-1.13
668,669,92,92,134,42,0.69
669,670,136,136,205,69,0.66
670,671,-164,37,260,223,-0.63
671,672,-199,287,287,0,-0.69
672,673,-181,20,101,81,-1.79
673,674,26,26,71,45,0.37
674,675,-174,27,263,236,-0.66
675,676,-346,140,140,0,-2.47
676,677,245,46,62,16,3.95
677,678,-377,109,109,0,-3.46
678,679,-422,64,64,0,-6.59
679,680,-168,33,175,142,-0.96
680,681,-180,21,177,156,-1.02
681,682,97,97,304,207,0.32
682,683,329,130,151,21,2.18
683,684,-448,38,38,0,-11.79
684,685,-428,58,58,0,-7.38
685,686,-189,12,61,49,-3.1
686,687,-361,125,125,0,-2.89
687,688,-467,19,19,0,-24.58
688,689,56,56,156,100,0.36
689,690,76,76,229,153,0.33
690,691,158,158,369,211,0.43
691,692,-376,110,110,0,-3.42
692,693,-198,3,178,175,-1.11
693,694,-183,18,361,343,-0.51
694,695,-179,22,175,153,-1.02
695,696,126,126,220,94,0.57
696,697,121,121,176,55,0.69
697,698,-459,27,27,0,-17.0
698,699,-283,203,203,0,-1.39
699,700,-445,41,41,0,-10.85
700,701,296,97,111,14,2.67
701,702,-288,198,198,0,-1.45
702,703,-155,46,183,137,-0.85
703,704,-188,13,62,49,-3.03
704,705,-458,28,28,0,-16.36
705,706,-193,8,93,85,-2.08
706,707,-456,30,280,250,-1.63
